03 03 03 03 03 03 03 03 03 03 03 03 03 03 03 03 03 03 03 03 03 03 03 03 03 03 03 03 03 03 03 03 03 03 03 03
27 24 24 24 28 03 03 03 29 23 23 23 23 30 03 03 03 03 03 03 03 29 23 23 23 23 30 03 03 03 03 03 03 03 03 03
01 01 01 01 01 00 00 00 27 39 22 22 22 25 00 00 00 00 00 00 00 26 22 22 22 40 28 00 00 00 00 00 00 00 03 03
03 03 00 00 00 00 00 00 00 26 22 22 22 25 00 00 00 00 00 00 00 26 22 22 22 25 00 00 00 00 00 00 00 00 03 03
03 03 00 00 00 00 00 00 00 26 22 22 40 28 00 00 00 00 00 00 00 27 39 22 22 25 00 00 00 00 00 00 00 00 03 03
23 30 00 00 00 00 00 00 29 37 22 22 25 00 00 00 00 00 00 00 00 00 26 22 22 38 30 00 00 00 00 00 00 00 03 03
22 25 00 00 00 00 00 00 27 24 24 24 28 00 00 00 00 00 00 00 00 00 27 24 24 24 28 00 00 00 00 00 00 00 03 03
22 25 00 00 00 00 00 00 01 06 01 01 01 00 00 00 07 08 09 00 00 00 01 01 01 06 01 00 00 00 00 00 00 00 03 03
22 25 00 00 00 00 00 00 00 00 00 00 00 00 00 00 10 00 11 00 00 00 00 00 00 00 00 00 00 00 00 00 00 00 03 03
22 25 00 00 00 00 00 00 00 00 00 00 00 00 00 00 12 13 14 00 00 00 00 00 00 00 00 00 00 00 00 00 00 00 03 03
22 25 00 00 00 00 00 00 00 00 00 00 00 00 00 00 00 00 00 00 00 00 00 00 00 00 00 00 00 00 00 00 00 00 03 03
22 25 00 00 00 00 00 00 29 23 23 23 23 23 23 23 23 23 23 23 23 23 23 23 23 23 30 00 00 00 00 00 00 00 03 03
22 25 00 00 00 00 00 00 26 22 22 22 22 22 22 22 22 22 22 22 22 22 22 22 22 22 25 00 00 00 00 00 00 00 03 03
22 25 00 00 00 00 00 00 27 24 24 24 24 24 24 24 24 24 24 24 24 24 24 24 24 24 28 00 00 00 00 00 00 00 03 03
22 25 00 00 00 00 00 00 01 01 01 01 01 01 01 01 01 01 01 01 01 01 01 01 01 01 01 00 00 00 00 00 00 00 03 03
22 25 00 00 00 00 00 00 36 17 17 17 17 17 17 17 17 17 17 17 17 17 17 17 17 17 36 00 00 00 00 00 00 00 03 03
22 25 00 00 00 00 00 00 35 17 18 19 17 17 17 18 19 17 17 18 19 17 17 18 19 17 35 00 00 00 00 00 00 00 03 03
22 25 00 00 00 00 00 00 31 02 02 02 02 02 02 02 02 02 02 02 02 02 02 02 02 02 33 00 00 00 00 00 00 00 03 03
22 25 00 00 00 00 00 00 32 02 02 02 02 02 02 02 02 02 02 02 02 02 02 02 02 02 34 00 00 00 00 00 00 00 03 03
22 25 00 00 00 00 00 00 36 20 21 17 17 20 21 17 17 20 21 17 17 20 21 17 17 17 36 00 00 00 00 00 00 00 03 03
22 25 00 00 00 00 00 00 36 17 17 17 17 17 17 17 17 17 17 17 17 17 17 17 17 17 36 00 00 00 00 00 00 00 03 03
22 25 00 00 00 00 00 00 29 23 23 23 23 23 23 23 23 23 23 23 23 23 23 23 23 23 30 00 00 00 00 00 00 00 03 03
22 25 00 00 00 00 00 00 26 22 22 22 22 22 22 22 22 22 22 22 22 22 22 22 22 22 25 00 00 00 00 00 00 00 03 03
22 25 00 00 00 00 00 00 27 24 24 24 24 24 24 24 24 24 24 24 24 24 24 24 24 24 28 00 00 00 00 00 00 00 03 03
22 25 00 00 00 00 00 00 01 01 01 06 01 01 06 01 01 01 01 06 01 01 01 01 01 01 01 00 00 00 00 00 00 00 03 03
22 25 00 00 00 00 00 00 00 00 00 00 00 00 00 00 00 00 00 00 00 00 00 00 00 00 00 00 00 00 00 00 00 00 03 03
22 25 00 00 00 00 00 00 00 00 00 00 00 00 00 00 07 08 09 00 00 00 00 00 00 00 00 00 00 00 00 00 00 00 03 03
22 25 00 00 00 00 00 00 00 00 00 00 00 00 00 00 10 00 11 00 00 00 00 00 00 00 00 00 00 00 00 00 00 00 03 03
22 25 00 00 00 00 00 00 29 23 23 23 30 00 00 00 12 13 14 00 00 00 29 23 23 23 30 00 00 00 00 00 00 00 03 03
22 25 00 00 00 00 00 00 27 39 03 03 25 00 00 00 00 00 00 00 00 00 26 03 03 40 28 00 00 00 00 00 00 00 03 03
22 25 00 00 00 00 00 00 01 26 03 03 38 23 23 23 23 23 23 23 23 23 37 03 03 25 01 00 00 00 00 00 00 00 03 03
22 25 00 00 00 00 00 00 00 26 03 03 03 03 03 03 03 03 03 03 03 03 03 03 03 25 00 00 00 00 00 00 00 00 03 03
22 25 00 00 00 00 00 00 00 26 03 03 03 03 03 03 03 03 03 03 03 03 03 03 03 25 00 00 00 00 00 00 00 00 03 03
22 25 00 00 00 00 00 00 29 37 03 03 03 03 03 03 03 03 03 03 03 03 03 03 03 38 30 00 00 00 00 00 00 00 03 03
24 28 03 03 03 03 03 03 27 24 24 24 24 24 24 24 24 24 24 24 24 24 24 24 24 24 28 03 03 03 03 03 03 00 03 03
01 01 03 03 03 03 03 03 01 01 01 01 01 01 01 01 01 01 01 01 01 01 01 01 01 01 01 03 03 03 03 03 03 00 03 03