29 23 23 23 30 46 46 46 29 23 23 23 23 30 46 46 46 46 46 46 46 29 23 23 23 23 30 46 46 46 29 23 23 23 23 30
27 24 24 24 28 46 46 46 27 39 22 22 22 25 46 46 46 46 46 46 46 26 22 22 22 40 28 46 46 46 27 24 24 24 24 28
01 01 01 01 01 60 60 60 01 26 22 22 22 25 60 60 60 60 60 60 60 26 22 22 22 25 01 60 60 60 01 01 01 01 01 01
45 45 61 00 00 00 00 00 56 26 22 22 40 28 00 00 00 00 00 00 00 27 39 22 22 25 56 00 00 00 00 00 00 59 44 44
45 45 61 00 00 00 00 00 00 26 22 22 25 01 00 00 00 00 00 00 00 01 26 22 22 25 00 00 00 00 00 00 00 59 44 44
23 30 00 00 00 00 00 00 29 37 22 22 25 00 00 00 00 00 00 00 00 00 26 22 22 38 30 00 00 00 00 00 00 00 29 23
22 25 00 00 00 00 00 00 27 24 24 24 28 00 00 00 00 00 00 00 00 00 27 24 24 24 28 00 00 00 00 00 00 00 26 22
22 25 00 00 00 00 00 00 01 06 01 01 01 00 00 00 07 08 09 00 00 00 01 01 01 06 01 00 00 00 00 00 00 00 26 22
22 25 00 00 00 00 00 00 00 00 00 00 00 00 00 00 10 00 11 00 00 00 00 00 00 00 00 00 00 00 00 00 00 00 26 22
22 25 00 00 00 00 00 00 00 00 00 00 00 00 00 00 12 13 14 00 00 00 00 00 00 00 00 00 00 00 00 00 00 00 26 22
22 25 00 00 00 00 00 00 00 00 00 00 00 00 00 00 00 00 00 00 00 00 00 00 00 00 00 00 00 00 00 00 00 00 26 22
22 25 00 00 00 00 00 00 29 23 23 23 23 23 23 23 23 23 23 23 23 23 23 23 23 23 30 00 00 00 00 00 00 00 26 22
22 25 00 00 00 00 00 00 26 22 22 22 22 22 22 22 22 22 22 22 22 22 22 22 22 22 25 00 00 00 00 00 00 00 26 22
22 25 00 00 00 00 00 00 27 24 24 24 24 24 24 24 24 24 24 24 24 24 24 24 24 24 28 00 00 00 00 00 00 00 26 22
22 25 00 00 00 00 00 00 01 01 01 01 01 01 01 01 01 01 01 01 01 01 01 01 01 01 01 00 00 00 00 00 00 00 26 22
22 25 00 00 00 00 00 00 36 17 17 17 17 17 17 17 17 17 17 17 17 17 17 17 17 17 36 00 00 00 00 00 00 00 26 22
22 25 00 00 00 00 00 00 35 17 18 19 17 17 17 18 19 17 17 18 19 17 17 18 19 17 35 00 00 00 00 00 00 00 26 22
22 25 00 00 00 00 00 00 31 02 02 02 02 02 02 02 02 02 02 02 02 02 02 02 02 02 33 00 00 00 00 00 00 00 26 22
22 25 00 00 00 00 00 00 32 02 02 02 02 02 02 02 02 02 02 02 02 02 02 02 02 02 34 00 00 00 00 00 00 00 26 22
22 25 00 00 00 00 00 00 36 20 21 17 17 20 21 17 17 20 21 17 17 20 21 17 17 17 36 00 00 00 00 00 00 00 26 22
22 25 00 00 00 00 00 00 36 17 17 17 17 17 17 17 17 17 17 17 17 17 17 17 17 17 36 00 00 00 00 00 00 00 26 22
22 25 00 00 00 00 00 00 29 23 23 23 23 23 23 23 23 23 23 23 23 23 23 23 23 23 30 00 00 00 00 00 00 00 26 22
22 25 00 00 00 00 00 00 26 22 22 22 22 22 22 22 22 22 22 22 22 22 22 22 22 22 25 00 00 00 00 00 00 00 26 22
22 25 00 00 00 00 00 00 27 24 24 24 24 24 24 24 24 24 24 24 24 24 24 24 24 24 28 00 00 00 00 00 00 00 26 22
22 25 00 00 00 00 00 00 01 01 01 06 01 01 01 06 01 01 01 06 01 01 01 06 01 43 01 00 00 00 00 00 00 00 26 22
22 25 00 00 00 00 00 00 00 00 00 00 00 00 00 00 00 00 00 00 00 00 00 00 00 00 00 00 00 00 00 00 00 00 26 22
22 25 00 00 00 00 00 00 00 00 00 00 00 00 00 00 07 08 09 00 00 00 00 00 00 00 00 00 00 00 00 00 00 00 26 22
22 25 00 00 00 00 00 00 00 00 00 00 00 00 00 00 10 00 11 00 00 00 00 00 00 00 00 00 00 00 00 00 00 00 26 22
22 25 00 00 00 00 00 00 29 23 23 23 30 00 00 00 12 13 14 00 00 00 29 23 23 23 30 00 00 00 00 00 00 00 26 22
22 25 00 00 00 00 00 00 27 39 22 22 25 00 00 00 00 00 00 00 00 00 26 22 22 40 28 00 00 00 00 00 00 00 26 22
24 28 00 00 00 00 00 00 01 26 22 22 25 00 00 00 00 00 00 00 00 00 26 22 22 25 01 00 00 00 00 00 00 00 27 24
45 45 61 00 00 00 00 00 56 26 22 22 38 30 00 00 00 00 00 00 00 29 37 22 22 25 56 00 00 00 00 00 00 59 44 44
45 45 61 00 00 00 00 00 00 26 22 22 22 25 00 00 00 00 00 00 00 26 22 22 22 25 00 00 00 00 00 00 00 59 44 44
29 23 23 23 30 58 58 58 29 37 22 22 22 25 58 58 58 58 58 58 58 26 22 22 22 38 30 58 58 58 29 23 23 23 23 30
27 24 24 24 28 41 41 41 27 24 24 24 24 28 41 41 41 41 41 41 41 27 24 24 24 24 28 41 41 41 27 24 24 24 24 28
01 01 01 01 01 41 41 41 01 01 01 01 01 01 41 41 41 41 41 41 41 01 01 01 01 01 01 41 41 41 01 01 01 01 01 01