29 23 23 23 23 23 23 23 23 23 23 23 23 23 23 23 23 23 23 23 23 23 23 23 23 23 23 23 23 23 23 23 23 23 23 30
26 40 24 24 24 24 24 24 24 39 22 22 22 22 22 22 22 22 22 22 22 22 22 22 22 40 24 24 24 24 24 24 24 24 39 25
26 25 01 01 01 01 01 01 01 26 22 22 22 22 22 22 22 22 22 22 22 22 22 22 22 25 01 01 01 01 01 01 01 01 26 25
26 25 00 00 00 00 00 00 00 26 22 22 22 22 22 22 22 22 22 22 22 22 22 22 22 25 00 00 00 00 00 00 00 00 26 25
26 25 00 00 00 00 00 00 57 26 22 22 22 22 22 22 22 22 22 22 22 22 22 22 22 25 57 00 00 00 00 00 00 00 26 25
26 25 00 00 00 00 00 00 29 37 22 22 22 22 22 22 22 22 22 22 22 22 22 22 22 38 30 00 00 00 00 00 00 00 26 25
26 25 00 00 00 00 00 00 27 24 24 24 24 24 24 24 24 24 24 24 24 24 24 24 24 24 28 00 00 00 00 00 00 00 26 25
26 25 00 00 00 00 00 00 01 01 01 06 01 01 01 06 01 01 01 06 01 01 01 06 01 01 01 00 00 00 00 00 00 00 26 25
26 25 00 00 00 00 00 00 00 00 00 00 00 00 00 00 00 00 00 00 00 00 00 00 00 00 00 00 00 00 00 00 00 00 26 25
26 25 00 00 00 00 00 00 00 00 00 00 00 00 00 00 00 00 00 00 00 00 00 00 00 00 00 00 00 00 00 00 00 00 26 25
26 25 00 00 00 00 00 00 00 00 00 00 00 00 00 00 00 00 00 00 00 00 00 00 00 00 00 00 00 00 00 00 00 00 26 25
26 25 00 00 00 00 00 00 29 23 23 23 23 23 23 23 23 23 23 23 23 23 23 23 23 23 30 00 00 00 00 00 00 00 26 25
26 25 00 00 00 00 00 00 26 22 22 22 22 22 22 22 22 22 22 22 22 22 22 22 22 22 25 00 00 00 00 00 00 00 26 25
26 25 00 00 00 00 00 00 26 40 24 24 24 24 24 24 24 24 24 24 24 24 24 24 24 39 25 00 00 00 00 00 00 00 26 25
26 25 00 00 00 00 00 00 26 25 01 01 01 01 01 01 01 01 01 01 01 01 01 01 01 26 25 00 00 00 00 00 00 00 26 25
26 25 00 00 00 00 00 00 26 25 03 03 03 03 03 03 03 03 03 03 03 03 03 03 03 26 25 00 00 00 00 00 00 00 26 25
26 25 00 00 00 00 00 00 26 25 03 03 03 03 03 03 03 03 03 03 03 03 03 03 03 26 25 00 00 00 00 00 00 00 26 25
26 25 00 00 00 00 00 00 26 25 03 03 03 03 03 03 03 03 03 03 03 03 03 03 03 26 25 00 00 00 00 00 00 00 26 25
26 25 00 00 00 00 00 00 26 25 03 03 03 03 03 03 03 03 03 03 03 03 03 03 03 26 25 00 00 00 00 00 00 00 26 25
26 25 00 00 00 00 00 00 26 25 03 03 03 03 03 03 03 03 03 03 03 03 03 03 03 26 25 00 00 00 00 00 00 00 26 25
26 25 00 00 00 00 00 00 26 25 03 03 03 03 03 03 03 03 03 03 03 03 03 03 03 26 25 00 00 00 00 00 00 00 26 25
26 25 00 00 00 00 00 00 26 38 23 23 23 23 23 23 23 23 23 23 23 23 23 23 23 37 25 00 00 00 00 00 00 00 26 25
26 25 00 00 00 00 00 00 26 22 22 22 22 22 22 22 22 22 22 22 22 22 22 22 22 22 25 00 00 00 00 00 00 00 26 25
26 25 00 00 00 00 00 00 27 24 24 24 24 24 24 24 24 24 24 24 24 24 24 24 24 24 28 00 00 00 00 00 00 00 26 25
26 25 00 00 00 00 00 00 01 01 01 06 01 01 01 06 01 01 01 06 01 01 01 06 01 01 01 00 00 00 00 00 00 00 26 25
26 25 00 00 00 00 00 00 00 00 00 00 00 00 00 00 00 00 00 00 00 00 00 00 00 00 00 00 00 00 00 00 00 00 26 25
26 25 00 00 00 00 00 00 00 00 00 00 00 00 00 00 00 00 00 00 00 00 00 00 00 00 00 00 00 00 00 00 00 00 26 25
26 25 00 00 00 00 00 00 00 00 00 00 00 00 00 00 00 00 00 00 00 00 00 00 00 00 00 00 00 00 00 00 00 00 26 25
26 25 00 00 00 00 00 00 29 23 23 23 23 23 23 23 23 23 23 23 23 23 23 23 23 23 30 00 00 00 00 00 00 00 26 25
26 25 00 00 00 00 00 00 27 39 22 22 22 22 22 22 22 22 22 22 22 22 22 22 22 40 28 00 00 00 00 00 00 00 26 25
26 25 00 00 00 00 00 00 01 26 22 22 22 22 22 22 22 22 22 22 22 22 22 22 22 25 01 00 00 00 00 00 00 00 26 25
26 25 00 00 00 00 00 00 00 26 22 22 22 22 22 22 22 22 22 22 22 22 22 22 22 25 00 00 00 00 00 00 00 00 26 25
26 25 00 00 00 00 00 00 57 26 22 22 22 22 22 22 22 22 22 22 22 22 22 22 22 25 57 00 00 00 00 00 00 00 26 25
26 38 23 23 23 23 23 23 23 37 22 22 22 22 22 22 22 22 22 22 22 22 22 22 22 38 23 23 23 23 23 23 23 23 37 25
27 24 24 24 24 24 24 24 24 24 24 24 24 24 24 24 24 24 24 24 24 24 24 24 24 24 24 24 24 24 24 24 24 24 24 28
01 01 01 01 01 01 01 01 01 01 01 01 01 01 01 01 01 01 01 01 01 01 01 01 01 01 01 01 01 01 01 01 01 01 01 01