03 03 03 03 03 03 03 03 03 03 03 03 03 03 03 03 03 03 03 03 03 03 03 03 03 03 03 03 03 03 03 03 03 03 03 03 
03 03 03 03 29 23 23 23 23 23 23 23 23 23 23 23 23 23 23 23 23 23 30 03 03 03 03 03 03 03 03 03 03 03 03 03
03 03 03 03 26 40 24 24 24 24 24 24 24 24 24 24 24 24 24 24 24 39 25 03 03 03 03 03 03 03 03 03 03 03 03 03
03 03 03 03 26 25 01 01 01 01 01 01 01 01 01 01 01 01 01 01 01 26 25 03 03 03 03 03 03 03 03 03 03 03 03 03
03 03 03 03 26 25 01 01 01 01 01 01 01 01 01 01 01 01 01 01 01 26 25 03 03 03 03 03 03 03 03 03 03 03 03 03
03 03 03 03 26 25 97 97 97 97 97 97 97 97 97 97 97 97 97 97 97 26 25 03 03 03 03 03 03 03 03 03 03 03 03 03
03 03 03 03 26 25 98 98 98 98 98 98 98 98 98 98 98 98 98 98 97 26 25 03 03 03 03 03 03 03 03 03 03 03 03 03
03 03 03 03 26 25 97 98 97 97 97 97 97 97 97 97 98 97 97 97 97 26 25 03 03 03 03 03 03 03 03 03 03 03 03 03
03 03 03 03 26 25 97 98 97 98 97 97 97 97 98 97 98 97 98 97 98 26 25 03 03 03 03 03 03 03 03 03 03 03 03 03
03 03 03 03 26 25 97 98 97 98 97 97 97 97 98 97 98 97 98 97 98 26 25 03 03 03 03 03 03 03 03 03 03 03 03 03
03 03 03 03 26 25 97 97 97 97 98 97 98 97 98 97 97 97 98 97 98 26 25 03 03 03 03 03 03 03 03 03 03 03 03 03
03 03 03 03 26 25 98 98 98 98 98 97 98 97 98 98 98 98 98 98 98 26 25 03 03 03 03 03 03 03 03 03 03 03 03 03
03 03 03 03 26 25 97 97 97 97 98 97 98 97 97 97 97 97 97 97 97 26 25 03 03 03 03 03 03 03 03 03 03 03 03 03
03 03 03 03 26 25 98 98 98 97 98 97 98 97 98 98 98 98 98 98 97 26 25 03 03 03 03 03 03 03 03 03 03 03 03 03
03 03 03 03 26 25 97 97 97 97 97 98 98 98 97 98 97 97 97 98 97 26 25 03 03 03 03 03 03 03 03 03 03 03 03 03
03 03 03 03 26 25 98 98 98 98 97 97 97 98 97 98 97 98 97 98 97 26 25 03 03 03 03 03 03 03 03 03 03 03 03 03
03 03 03 03 26 25 97 97 97 98 97 97 97 98 97 98 97 98 97 98 97 26 25 03 03 03 03 03 03 03 03 03 03 03 03 03
03 03 03 03 26 25 97 98 97 98 97 97 97 97 97 97 97 98 97 97 97 26 25 03 03 03 03 03 03 03 03 03 03 03 03 03
03 03 03 03 26 25 97 98 97 98 97 98 98 97 98 97 98 98 98 98 98 26 25 03 03 03 03 03 03 03 03 03 03 03 03 03
03 03 03 03 26 25 97 98 97 97 97 97 98 97 98 97 97 97 97 97 97 26 25 03 03 03 03 03 03 03 03 03 03 03 03 03
03 03 03 03 26 38 23 23 23 23 23 23 30 97 29 23 23 23 23 23 23 37 25 03 03 03 03 03 03 03 03 03 03 03 03 03
03 03 03 03 27 24 24 24 24 24 24 24 28 97 27 24 24 24 24 24 24 24 28 03 03 03 03 03 03 03 03 03 03 03 03 03
03 03 03 03 01 01 01 01 01 01 01 01 01 97 01 01 01 01 01 01 01 01 01 03 03 03 03 03 03 03 03 03 03 03 03 03
03 03 03 03 03 03 03 03 03 03 03 03 03 03 03 03 03 03 03 03 03 03 03 03 03 03 03 03 03 03 03 03 03 03 03 03
03 03 03 03 03 03 03 03 03 03 03 03 03 03 03 03 03 03 03 03 03 03 03 03 03 03 03 03 03 03 03 03 03 03 03 03
03 03 03 03 03 03 03 03 03 03 03 03 03 03 03 03 03 03 03 03 03 03 03 03 03 03 03 03 03 03 03 03 03 03 03 03
03 03 03 03 03 03 03 03 03 03 03 03 03 03 03 03 03 03 03 03 03 03 03 03 03 03 03 03 03 03 03 03 03 03 03 03
03 03 03 03 03 03 03 03 03 03 03 03 03 03 03 03 03 03 03 03 03 03 03 03 03 03 03 03 03 03 03 03 03 03 03 03
03 03 03 03 03 03 03 03 03 03 03 03 03 03 03 03 03 03 03 03 03 03 03 03 03 03 03 03 03 03 03 03 03 03 03 03
03 03 03 03 03 03 03 03 03 03 03 03 03 03 03 03 03 03 03 03 03 03 03 03 03 03 03 03 03 03 03 03 03 03 03 03
03 03 03 03 03 03 03 03 03 03 03 03 03 03 03 03 03 03 03 03 03 03 03 03 03 03 03 03 03 03 03 03 03 03 03 03
03 03 03 03 03 03 03 03 03 03 03 03 03 03 03 03 03 03 03 03 03 03 03 03 03 03 03 03 03 03 03 03 03 03 03 03
03 03 03 03 03 03 03 03 03 03 03 03 03 03 03 03 03 03 03 03 03 03 03 03 03 03 03 03 03 03 03 03 03 03 03 03
03 03 03 03 03 03 03 03 03 03 03 03 03 03 03 03 03 03 03 03 03 03 03 03 03 03 03 03 03 03 03 03 03 03 03 03
03 03 03 03 03 03 03 03 03 03 03 03 03 03 03 03 03 03 03 03 03 03 03 03 03 03 03 03 03 03 03 03 03 03 03 03
03 03 03 03 03 03 03 03 03 03 03 03 03 03 03 03 03 03 03 03 03 03 03 03 03 03 03 03 03 03 03 03 03 03 03 03